{
    "map_01": {
        "key": "map_01",
        "name": "Jack In The Box", 
        "author": "orion3dgames",    
        "width": 20,
        "height": 12,
        "data": [
            ["W", "W", "W", "W", "W", "W", "W", "W", "W", "W", "W", "W", "W", "W", "W", "W", "W", "W", "W", "W"],
            ["W", "S", " ", " ", " ", " ", " ", " ", " ", " ", " ", " ", " ", " ", " ", " ", " ", " ", "S", "W"],
            ["W", " ", " ", " ", " ", " ", " ", " ", " ", " ", " ", " ", " ", " ", " ", " ", " ", " ", " ", "W"],
            ["W", " ", " ", "W", "W", " ", " ", "W", "W", " ", " ", "W", "W", " ", " ", "W", "W", " ", " ", "W"],
            ["W", " ", " ", "W", "W", " ", " ", "W", "W", " ", " ", "W", "W", " ", " ", "W", "W", " ", " ", "W"],
            ["W", " ", " ", " ", " ", " ", " ", " ", " ", " ", " ", " ", " ", " ", " ", " ", " ", " ", " ", "W"],
            ["W", " ", " ", " ", " ", " ", " ", " ", " ", " ", " ", " ", " ", " ", " ", " ", " ", " ", " ", "W"],
            ["W", " ", " ", "W", "W", " ", " ", "W", "W", " ", " ", "W", "W", " ", " ", "W", "W", " ", " ", "W"],
            ["W", " ", " ", "W", "W", " ", " ", "W", "W", " ", " ", "W", "W", " ", " ", "W", "W", " ", " ", "W"],
            ["W", " ", " ", " ", " ", " ", " ", " ", " ", " ", " ", " ", " ", " ", " ", " ", " ", " ", " ", "W"],
            ["W", "S", " ", " ", " ", " ", " ", " ", " ", " ", " ", " ", " ", " ", " ", " ", " ", " ", "S", "W"],
            ["W", "W", "W", "W", "W", "W", "W", "W", "W", "W", "W", "W", "W", "W", "W", "W", "W", "W", "W", "W"]
        ]
    },
    "map_02": {
        "key": "map_02",
        "name": "Red Tulip",
        "author": "orion3dgames",
        "width": 20,
        "height": 14,
        "data": [
            ["W", "W", "W", "W", "W", "W", "W", "W", "W", "W", "W", "W", "W", "W", "W", "W", "W", "W", "W", "W"],
            ["W", "S", " ", " ", " ", " ", " ", " ", " ", " ", " ", " ", " ", " ", " ", " ", " ", " ", "S", "W"],
            ["W", " ", " ", " ", " ", " ", " ", " ", " ", " ", " ", " ", " ", " ", " ", " ", " ", " ", " ", "W"],
            ["W", "W", "W", "W", "W", "W", "W", "W", "W", "W", " ", " ", " ", " ", " ", " ", " ", " ", " ", "W"],
            ["W", " ", " ", " ", " ", " ", " ", " ", "W", "W", " ", " ", " ", " ", " ", " ", " ", " ", " ", "W"],
            ["W", " ", " ", " ", " ", " ", " ", " ", "W", "W", " ", " ", " ", " ", "W", "W", "W", "W", "W", "W"],
            ["W", " ", " ", " ", " ", " ", " ", " ", " ", " ", " ", " ", " ", " ", "W", "W", "W", "W", "W", "W"],
            ["W", "W", "W", "W", "W", "W", " ", " ", " ", " ", " ", " ", " ", " ", " ", " ", " ", " ", " ", "W"],
            ["W", "W", "W", "W", "W", "W", " ", " ", " ", "W", "W", " ", " ", " ", " ", " ", " ", " ", " ", "W"],
            ["W", " ", " ", " ", " ", " ", " ", " ", " ", "W", "W", " ", " ", " ", " ", " ", " ", " ", " ", "W"],
            ["W", " ", " ", " ", " ", " ", " ", " ", " ", "W", "W", "W", "W", "W", "W", "W", "W", "W", "W", "W"],
            ["W", " ", " ", " ", " ", " ", " ", " ", " ", " ", " ", " ", " ", " ", " ", " ", " ", " ", " ", "W"],
            ["W", "S", " ", " ", " ", " ", " ", " ", " ", " ", " ", " ", " ", " ", " ", " ", " ", " ", "S", "W"],
            ["W", "W", "W", "W", "W", "W", "W", "W", "W", "W", "W", "W", "W", "W", "W", "W", "W", "W", "W", "W"]
        ]
    },
    "map_03": {
        "key": "map_03",
        "name": "Red Tulip",
        "author": "orion3dgames",
        "width": 20,
        "height": 14,
        "data": [
            ["W", "W", "W", "W", "W", "W", "W", "W", "W", "W", "W", "W", "W", "W", "W", "W", "W", "W", "W", "W"],
            ["W", "S", " ", " ", " ", " ", " ", " ", " ", " ", " ", " ", " ", " ", " ", " ", " ", " ", "S", "W"],
            ["W", " ", " ", " ", " ", " ", " ", " ", " ", " ", " ", " ", " ", " ", " ", " ", " ", " ", " ", "W"],
            ["W", "W", "W", "W", "W", "W", "W", "W", "W", "W", " ", " ", " ", " ", " ", " ", " ", " ", " ", "W"],
            ["W", " ", " ", " ", " ", " ", " ", " ", "W", "W", " ", " ", " ", " ", " ", " ", " ", " ", " ", "W"],
            ["W", " ", " ", " ", " ", " ", " ", " ", "W", "W", " ", " ", " ", " ", "W", "W", "W", "W", "W", "W"],
            ["W", " ", " ", " ", " ", " ", " ", " ", " ", " ", " ", " ", " ", " ", "W", "W", "W", "W", "W", "W"],
            ["W", "W", "W", "W", "W", "W", " ", " ", " ", " ", " ", " ", " ", " ", " ", " ", " ", " ", " ", "W"],
            ["W", "W", "W", "W", "W", "W", " ", " ", " ", "W", "W", " ", " ", " ", " ", " ", " ", " ", " ", "W"],
            ["W", " ", " ", " ", " ", " ", " ", " ", " ", "W", "W", " ", " ", " ", " ", " ", " ", " ", " ", "W"],
            ["W", " ", " ", " ", " ", " ", " ", " ", " ", "W", "W", "W", "W", "W", "W", "W", "W", "W", "W", "W"],
            ["W", " ", " ", " ", " ", " ", " ", " ", " ", " ", " ", " ", " ", " ", " ", " ", " ", " ", " ", "W"],
            ["W", "S", " ", " ", " ", " ", " ", " ", " ", " ", " ", " ", " ", " ", " ", " ", " ", " ", "S", "W"],
            ["W", "W", "W", "W", "W", "W", "W", "W", "W", "W", "W", "W", "W", "W", "W", "W", "W", "W", "W", "W"]
        ]
    },
    "map_04": {
        "key": "map_04",
        "name": "Red Tulip",
        "author": "orion3dgames",
        "width": 20,
        "height": 14,
        "data": [
            ["W", "W", "W", "W", "W", "W", "W", "W", "W", "W", "W", "W", "W", "W", "W", "W", "W", "W", "W", "W"],
            ["W", "S", " ", " ", " ", " ", " ", " ", " ", " ", " ", " ", " ", " ", " ", " ", " ", " ", "S", "W"],
            ["W", " ", " ", " ", " ", " ", " ", " ", " ", " ", " ", " ", " ", " ", " ", " ", " ", " ", " ", "W"],
            ["W", "W", "W", "W", "W", "W", "W", "W", "W", "W", " ", " ", " ", " ", " ", " ", " ", " ", " ", "W"],
            ["W", " ", " ", " ", " ", " ", " ", " ", "W", "W", " ", " ", " ", " ", " ", " ", " ", " ", " ", "W"],
            ["W", " ", " ", " ", " ", " ", " ", " ", "W", "W", " ", " ", " ", " ", "W", "W", "W", "W", "W", "W"],
            ["W", " ", " ", " ", " ", " ", " ", " ", " ", " ", " ", " ", " ", " ", "W", "W", "W", "W", "W", "W"],
            ["W", "W", "W", "W", "W", "W", " ", " ", " ", " ", " ", " ", " ", " ", " ", " ", " ", " ", " ", "W"],
            ["W", "W", "W", "W", "W", "W", " ", " ", " ", "W", "W", " ", " ", " ", " ", " ", " ", " ", " ", "W"],
            ["W", " ", " ", " ", " ", " ", " ", " ", " ", "W", "W", " ", " ", " ", " ", " ", " ", " ", " ", "W"],
            ["W", " ", " ", " ", " ", " ", " ", " ", " ", "W", "W", "W", "W", "W", "W", "W", "W", "W", "W", "W"],
            ["W", " ", " ", " ", " ", " ", " ", " ", " ", " ", " ", " ", " ", " ", " ", " ", " ", " ", " ", "W"],
            ["W", "S", " ", " ", " ", " ", " ", " ", " ", " ", " ", " ", " ", " ", " ", " ", " ", " ", "S", "W"],
            ["W", "W", "W", "W", "W", "W", "W", "W", "W", "W", "W", "W", "W", "W", "W", "W", "W", "W", "W", "W"]
        ]
    },
    "map_05": {
        "key": "map_05",
        "name": "Red Tulip",
        "author": "orion3dgames",
        "width": 20,
        "height": 14,
        "data": [
            ["W", "W", "W", "W", "W", "W", "W", "W", "W", "W", "W", "W", "W", "W", "W", "W", "W", "W", "W", "W"],
            ["W", "S", " ", " ", " ", " ", " ", " ", " ", " ", " ", " ", " ", " ", " ", " ", " ", " ", "S", "W"],
            ["W", " ", " ", " ", " ", " ", " ", " ", " ", " ", " ", " ", " ", " ", " ", " ", " ", " ", " ", "W"],
            ["W", "W", "W", "W", "W", "W", "W", "W", "W", "W", " ", " ", " ", " ", " ", " ", " ", " ", " ", "W"],
            ["W", " ", " ", " ", " ", " ", " ", " ", "W", "W", " ", " ", " ", " ", " ", " ", " ", " ", " ", "W"],
            ["W", " ", " ", " ", " ", " ", " ", " ", "W", "W", " ", " ", " ", " ", "W", "W", "W", "W", "W", "W"],
            ["W", " ", " ", " ", " ", " ", " ", " ", " ", " ", " ", " ", " ", " ", "W", "W", "W", "W", "W", "W"],
            ["W", "W", "W", "W", "W", "W", " ", " ", " ", " ", " ", " ", " ", " ", " ", " ", " ", " ", " ", "W"],
            ["W", "W", "W", "W", "W", "W", " ", " ", " ", "W", "W", " ", " ", " ", " ", " ", " ", " ", " ", "W"],
            ["W", " ", " ", " ", " ", " ", " ", " ", " ", "W", "W", " ", " ", " ", " ", " ", " ", " ", " ", "W"],
            ["W", " ", " ", " ", " ", " ", " ", " ", " ", "W", "W", "W", "W", "W", "W", "W", "W", "W", "W", "W"],
            ["W", " ", " ", " ", " ", " ", " ", " ", " ", " ", " ", " ", " ", " ", " ", " ", " ", " ", " ", "W"],
            ["W", "S", " ", " ", " ", " ", " ", " ", " ", " ", " ", " ", " ", " ", " ", " ", " ", " ", "S", "W"],
            ["W", "W", "W", "W", "W", "W", "W", "W", "W", "W", "W", "W", "W", "W", "W", "W", "W", "W", "W", "W"]
        ]
    },
    "map_06": {
        "key": "map_06",
        "name": "Red Tulip",
        "author": "orion3dgames",
        "width": 20,
        "height": 14,
        "data": [
            ["W", "W", "W", "W", "W", "W", "W", "W", "W", "W", "W", "W", "W", "W", "W", "W", "W", "W", "W", "W"],
            ["W", "S", " ", " ", " ", " ", " ", " ", " ", " ", " ", " ", " ", " ", " ", " ", " ", " ", "S", "W"],
            ["W", " ", " ", " ", " ", " ", " ", " ", " ", " ", " ", " ", " ", " ", " ", " ", " ", " ", " ", "W"],
            ["W", "W", "W", "W", "W", "W", "W", "W", "W", "W", " ", " ", " ", " ", " ", " ", " ", " ", " ", "W"],
            ["W", " ", " ", " ", " ", " ", " ", " ", "W", "W", " ", " ", " ", " ", " ", " ", " ", " ", " ", "W"],
            ["W", " ", " ", " ", " ", " ", " ", " ", "W", "W", " ", " ", " ", " ", "W", "W", "W", "W", "W", "W"],
            ["W", " ", " ", " ", " ", " ", " ", " ", " ", " ", " ", " ", " ", " ", "W", "W", "W", "W", "W", "W"],
            ["W", "W", "W", "W", "W", "W", " ", " ", " ", " ", " ", " ", " ", " ", " ", " ", " ", " ", " ", "W"],
            ["W", "W", "W", "W", "W", "W", " ", " ", " ", "W", "W", " ", " ", " ", " ", " ", " ", " ", " ", "W"],
            ["W", " ", " ", " ", " ", " ", " ", " ", " ", "W", "W", " ", " ", " ", " ", " ", " ", " ", " ", "W"],
            ["W", " ", " ", " ", " ", " ", " ", " ", " ", "W", "W", "W", "W", "W", "W", "W", "W", "W", "W", "W"],
            ["W", " ", " ", " ", " ", " ", " ", " ", " ", " ", " ", " ", " ", " ", " ", " ", " ", " ", " ", "W"],
            ["W", "S", " ", " ", " ", " ", " ", " ", " ", " ", " ", " ", " ", " ", " ", " ", " ", " ", "S", "W"],
            ["W", "W", "W", "W", "W", "W", "W", "W", "W", "W", "W", "W", "W", "W", "W", "W", "W", "W", "W", "W"]
        ]
    }
    
}